

111111111111111
1C1100000000C01
111101111100001
100001111100001
1P0011E00000001
111111111111111

