

111111111111111
100100000000C01
100101111100001
100001111100P01
1P0011E00000001
111111111111111

