

111111111111111
1E0100000000C01
100101111100001
100001111100001
1P0011E000000E1
111111111111111

