

111111111111111
1C0100000000C01
100101111100001
100001111100001
1P0011E10000001
111111111111111

