1111111111111111111111111111111111
1E0000000000000C00000C000000000001
1010010100100000101001000000010101
1010010010101010001001000000010101
1000000000000000000000000000000001
1P0000000C00C0000000000000000000C1
1000000000000000000000000000000001
1111111111101110010101010101010101
1000000000000000000000000000000001
10V0000000000000000000000000000001
1000000000000011100111111110000001
1000000000000111000110001110000001
1000000000001110000100001110000001
1000000000111000000000011100000001
1000000001110000000000111000000001
1000000011100000000001110000000001
1000000111111111100011100010000001
1000000111111111100111000110000001
1000000000000011100111001110000001
1000000000000011100111111110000001
1000000000000000000000000000000001
1111111111111111111111111111111111