

11111111111111111
10000000000000001
10111111111111101
1010010000000C101
10100001111100101
101P0011E00000101
10111111111111101
10000000000000001
11111111111111111

