11111
10101
10001
1P111
101E1
10101
10101
1C101
10101
10001
10001
10001
10001
10001
10001
10001
10001
10001
11111